Dresden Sophienkirche
Trauungen 1541-1659
https://www.archion.de/de/viewer/churchRegister/280099?pageId=38535018

Das ist ein einfacher Index aller Trauungen.
Die Schreibweise der Namen entspricht nicht immer der Schreibweise im Buch, adelige Nachnamen wurde verkürzt.

Dieser Index wurde auf der Grundlage des Werkes "Die Dresdner Schlosskirchenbücher" von Christa Maria Richter erstellt:
https://slub.qucosa.de/landing-page/?tx_dlf[id]=https%3A%2F%2Fslub.qucosa.de%2Fapi%2Fqucosa%253A74092%2Fmets


Juli 2024
https://github.com/tintenfrass/simplechurchbookindexes



---------------- x7
1541
Moritz Sachsen | Agnes Hessen
----------------
----------------
1548
August Sachsen | Anna Dänemark
---------------- x5
1568
Casimir Pfalz | Elisabeth Sachsen
1585
Heinrich Julius Brauschweig | Dorothea Sachsen
----------------
1586
Johann Casimir SachsenCoburg | Anna Sachsen
---------------- x4
1582
Christian Sachsen | Sophia Brandenburg
---------------- x9
1602
Christian Sachsen | Hedwig Dänemark
---------------- x7
1604
Johann Georg Sachsen | Sibylla Elisabeth Württemberg
----------------
1607
Johann Georg Sachsen | Magdalena Sibylla Preußen
---------------- x6
1541
Moritz Sachsen | Agnes Hessen
1548
August Sachsen | Anna Dänemark
1586
August Sachsen | Agnes Hedwig Anhalt
----------------
1561
Wilhelm Oranien | Anna Sachsen
1568
Casimir Pfalz | Elisabeth Sachsen
1587
Heinrich Julius Brauschweig | Dorothea Sachsen
1582
Christian Sachsen | Sophia Brandenburg
----------------
1586
Johann Casimir SachsenCoburg | Anna Sachsen
1602
Christian Sachsen | Hedwig Dänemark
1604
Johann Georg Sachsen | Sibylla Elisabeth Württemberg
----------------
1607
Johann Georg Sachsen | Magdalena Sibylla Preußen
1610
Franz Pommern | Sophia Sachsen
----------------
1612
August Sachsen | Elisabeth Braunschweig
----------------
1627
Georg Hessen | Sophia Eleonora Sachsen
----------------
1630
Friedrich SchleswigHolstein | Maria Elisabeth Sachsen
---------------- x5
1638
Johann Georg Sachsen | Magdalena Sibylla Brandenburg
----------------
1649
Johann Anhalt | Sophia Augusta Holstein
----------------
1650
Wilhelm Christoph Hessen | Sophia Eleonora Hessen
----------------
Christian Sachsen | Christiane SchleswigHolstein
Moritz Sachsen | Sophia Hedwig SchleswigHolstein
----------------
----------------
1652
Friedrich Wilhelm Altenburg | Magdalena Sibylla Sachsen
1662
Christian Ernst BrandenburgBayreuth | Erdmuthe Sophie Sachsen
1666
Johann Georg Sachsen | Anna Sophia Dänemark
1692
Johann Georg Sachsen | Eleonora Erdmuthe Luise SachsenEisenach
---------------- x356
1598
Burckhart Schenck Tautenburg | Agnes Eberstein
Hermann Barrleben | Magdalena Leutzschen
----------------
----------------
----------------
1603
Hans Georg OSterhaus | Maria Carlowitz
Walther Haubitz | Brigitta Grünrad
Centurio Pflug | Sara Starrstedel
Christoph Schliben | Elisabeth Grünrad
Martin Nageborn | Ursula Decker
Zacharias Wehm | Anna Hintermeier
Georg Geißler | Margaretha Müller
Ditrich Labyn | Maria ?
----------------
1604
Rudolph Schelentzky | Salome Zschier
Heinrich Miltitz | Anna Maria Ponicke
Balthasar Plinagel | Anna Günther
Hans Georg Hennig | Euphrasia Grübe
1605
Wenzel Hübner | Anna Maria Schaf
Georg Reichbrod | Barbara Ditrich
Johann Heimrich | Maria Münch
----------------
1606
1607
Hironimus Plfug | Magdalena Brandstein
Hironimus Stumpf | Gertraut Sauerbir
Simon Michel | Dorothea Kitzig
Wolf Münch | Martha Tribel
Hans Caspar Körbitz | Maria Loß
----------------
Siegmund Hübener | Katharina ?
1608
Christian Pfund | Magdalena Werner
Barthel Plunder | Anna Klengel
Martin Heidel | Gertraut Fischer
Gregor Hennig | Elisabeth Spregler
----------------
Siegmund Schlichting | Anna Kolreuter
1609
Sebastian Moritz Zehmen | Katharina Schelentzky
Gotschalch Günterrod | Dorothea Eckersberg
Christian Tribel | Barbara Funcke
Franz Böttcher | Anna Maria Wiedeman
----------------
Georg Seidewitz | Katharina Euphemia Berbisdorf
Hans Caspar Milcka | Maria Taubadel
Hans Jost Koßbot | Emerentia Sandersleben
Ditrich Taube | Veronica Lützelburg
Friedrich Müller | Anna Ditrich
Georg Zöllner | Künigunga Fritz
1611
Hans Ernst Pistorius | Margaretha Kandelberg
Georg Ernst Weißbach | Anna Trübel
----------------
Nicol Schönfeld | Maria Elisabeth Karaß
Hans Caspar Kannenwurf | Dorothea Alnpecken
Ludwig Wilhelm Moser | Anna Cracken
1613
Wolf Mela | Maria Löser
----------------
1614
Jobst Künemund Reitzenstein | Catharina Hanyn
Christoph Wolf | Eva Kannegießer
Georg Peßel | Anna Hennig
Johann Specht | Maria Fleischer
Jacob Frantz | Catharina Pietzsch
Barthel Dintus | Maria -
1615
1616
Siegmund Adolph Ziegeser | Sabina Loße
----------------
1617
Carl Christoph Horda | Ursula Miltitz
Severin Nehel | Anna Pauluß
Johann Vopelius | Helena Steündner
Hans Georg Osterhausen | Helena Haugwitz
Friedrich Sieber | Sophia -
----------------
1618
Georg VithumEckstsädt | Catharina Elisabeth Röbel
Zdeßlaus Hersain Harraß | Elisabeth Haugwitz
1619
Elias Strubel | Anna Maria Martin
Philip Jacob Nusser Dorothea Brothmayer
Melchior Jobe | Maria Bulmann
1620
----------------
Hans Taube | Agnes Minckwitz
Heinrich Taube | Clara Schütze
Ludwig Taube | Anna Maria Lützelburg
Caspar Fleming | Rosina Neumann
Niclaß Genitz | Susanna Kölbelin
Georg Braun | Margaretha Geißler
Johann Baptisa Magno | Anna Schlemin
----------------
1621
Georg Pflug | Magdalena Worm
Jacob Barhtolomæus | Dorothea Hübner
Eberhard Decke | Magdalena Roßwürm
Johann Ulman | Magdalena Hoffmann
----------------
1622
Valentin Romul | Maria Magdalena Clemm
1624
Reinhard Taube | Barbara Sybilla Carlowitz
Adam Rodewitz | Anna Elisabeth Bambach
----------------
Michael Zinckenagel | Sabina Jahne
Hans Tischer | Maria Steübisch
Johann Schenck | Brigitta Budiß
Hans Jonas Lilgenau | Helena Elisabeth Hoenegg
1627
Philip Röden | Maria Magdalena Plancken
Adam Adrian Walwitz | Sophia Catharina Ragewitz
Nicolaus Hoffmeister | Christina Foppe
----------------
Michael Wanner | Erdmuth Katharina Hein
Thomas Küchler | Barbara Diehn
Hans Caspar Kürbiz | Elisabeth Plänck
1629
Hans Bernhart Neithart | Magdalena Elisabeth Hoen
1630
----------------
Hans Wolf Gerßdorf | Ursula Haugwitz
Siegmund Adolph Ziegesar | Maria Einsidel
1631
Carl Christian Goldstein
1633
Friedrich Hermann Reckroth | Anna Sophia Marschalch
----------------
Leonhard Friedrich HoëHoënegg | Anna Sabina Pölniz
1634
Wolf Christoph Tarrach | Rosina Nostiz
Claus Taube | Anna Ludomilla Vollstedt
----------------
1635
- Sulzborger | - Müller
Veit Forchheim | Euphrosina Dachs
Sebastian Lüzelburg | Elisabeth Kürbiz
1636
Sebastian Mezsch | Sophia Elisabeth Loß
1637
Caspar Lache | Barbara Straus
----------------
1638
Johann Georg Rechtenberg | Perpetua Juliana Karlwitz
Johann Ruprecht Sulzberger | Elisabeth Kröse
Johann Willer | Elisabeth Laurentij
Friedrich Hermann Reckrod | Ursula Pflüg
Caspar Friedrich Brizke | Maria Hedwig Cannawurf
----------------
Johann Friedrich AmEnde | Sophia Laurentij
1639
Christian Loß | Margaretha Rabiel
Daniel Döring | Anna Catharina Seidlitz
Wolf Friedrich Muffel | Maria Sothon
----------------
1640
Ditloff Wedelbusch | Maria Elisabeth Bünau
Christian Döring | Sophia Elisabeth HoëHoënegg
Burckhard Perlich | Sophia Nehel
----------------
Joachim WisetzkyWitzky | Barbara Anna Rüdiger
Johann Rabe? | Regina Drötler
Georg Bütner | Dorothea Eleonora Jürgensen
1641
Werner Schwartz | Anna Rosina Baudis
----------------
Johann Wöchinger | Esther Gerhardt
Hans Georg Brandenstein | Catharina Wündschroden
Gottfried Reisiger | Anna Maria Nehel
Constantin Roth | Maria Gertraut Strauche
1642
Georg Haubold Berbisdorf | Anna Maria Drandorf
----------------
Samuel Siegelfischer | Elisabeth Lieben
Ægidius Strauch | Catharina Dorothea Findenkeller
Günther Bünau | Sara Bünau
Christoph Liebenau | Catharina Sophia Bombßdorf
----------------
Johann Georg Lackery | Margaretha -
Daniel Heinrich | Euphrosina Elisabeth Faber
1643
Samuel Fischer | Anna Maria Schöne
----------------
Albrecht Günderoth | Sophia Elisabeth Volcksted
Johann Mannslau | Anna Schmidt
Christian Willischius | Anna Maria Laurentij
Samuel Senff | Magdalena Sibylla Laurentij
----------------
Michael Sowitz? | Anna Hildebrand
1644
Hans Siegmund Hacke | Sara -
Christian Hartmann | Catharina Elisabeth Klengel
Heinrich Salhausen
Johann Haße | Anna Schneider
----------------
Ditrich Kracht | Dorothea Magdalena Marschalg
Daniel Schmidt | Anna Catharina Loß
Clauß Taube | Maria Ludigard Taube
----------------
Philip Alexius Büttner | Margaretha Romani
1645
Johann Georg Kretzschmar | Maria Sophia Walther
1646
Caspar Heinrich Taube | Magdalena Sophia Kanne
----------------
Georg Wilhelm Sebastian Heerdegen | Sabina Eleonora Ziegeser
Adam Kötzschta | Catharina Tillmann
Johann Georg Rechenberg | Magdalena Sophia Tauben
Dam Troida | Barbara Bose
----------------
1647
Philip Alexius Büttner | Johanna Hedwig Schäffer
Peter Fischer | Sophia Catharina Jürchen
Wolfgang Oelschlegel | Veronica Kirchbach
1648
Heinrich Siegmund Salisch | Elisabeth AusDemWinckel
Georg Ernst Dölau | Margaretha Pflüge
----------------
Curd Löser | Anna Sybilla Körbitz
Andreas Hartmann | Maria Elisabeth Ulmann
Zacharias Richter | Anna Margaretha Hillemeyer
Hans Heinrich Nostitz | Anna Gertraut Waße
1649
Wenzel Birckner | Margaretha Seidler
Jonas Kirchbach | Anna Dorothea Gaue
----------------
1650
Engelhard Silberland | Ludomilla Freie
Georg Ditrich Carlowitz | Anna Elisabeth Libenau
Georg Bartoldi | Maria Telarosch
Melchior Gebauer | Margaretha Walther
Alexander Krahe | Anna Dorothea Liebenau
1651
Thomas Nicolai | Helena Bretschneider
Christian Michael | Sibylla Jung
Mattheus Vogel | Susanna Troniche
Josias Weißler | Margaretha Bußdorf
Rudolph Miltitz | Eva Dorothea Streithorst
----------------
1652
Heinrich Johann Taube | Anna Magdalena Böcke
Wolf Heinrich Lüttichau | Margaretha Dreßkau
Hans Rudolph Gerßdorf | Catharina Veronica Rechenberg
Samuel Pol | Catharina Sachße
Friedrich Westhoff | Regina Tzschückin
Peter Mührisch | Ludomilla Piche
Johann Joachim Schober | Catharina Jägerndorfer
Peter Hardewick Zinziger | Martha Schlechter
----------------
Christoph Bergmnann | Regina Hermann
Georg Job Koseriz | Catharina Sophia Mezsche
Magnus Ornichen | Sophia Margaretha -
1653
Daniel Fraje | Susanna Sibylla Kuntmann
Christoph Siegmund Facilitas | Sabina Lösel
Christian Bürger | Dorothea Schröter
Sebastian Hildebrand Metzsch | Sophia AusDemWinckel
Hans Siegmund Pforta | Anna Eleonora Bünau
----------------
Christian Haßert | Anna Maria Holzmüller
Johann Meißner | Dorothea Rehebold
Christoph VithumEckstsädt | Anna Christina Tauben
1654
Christoph Laurentius | Maria Glaser
Salomon Friedrich Lincke | Anna Nühre
----------------
Johann Dixon | Magdalena Rose
Jonas Küttel | Anna Maria Müller
Georg Strübel | Sophia Elisabeth Dermint?
Adrian Arnd Plötz | Agnes Könderitz
1655
Christian Reichbrod? | Margaretha Heymann
----------------
Zacharias Walther | Anna Langschädlein
Caspar Haubold Körbiz | Anna Magdalena Koßbot
Christoph Ditrich Bose | Ursula Gusteth
Wolfgang Köler | Anna Margaretha Demünter
Hans Paul Rost | Anna Dorothea Jägerndorf
----------------
1656
Hans Otto Ponicau | Maria Sophia Gründroth
Johann Georg Rechenberg | Rachel Werthern
David Faber | Elisabeth Cotte
----------------
Reinhard Ditrich Taube | Rahel Friesen
----------------
Günther Bünau | Hedwig Holzendorf
Andreas Jahn | Dorothea Maria Weller
- Lackery | Magdalena Sybilla Lechner
Christian Siegmund Holzendorf | Elisabeth Dießkau
----------------
Johann Adolph Ziegesar | Maria Elisabeth Lüzelburg
Johann Georg Beyer | Veronica Oelschlegel
Albrecht Christian Krombsdorf | Clara Dorothea Harraß
Ludwig Gebhard Heimb | Elisabeth Sybilla Taube
----------------
1657
Johann Daume | Anna Maria Rose
Florian Otto | Christina Engelmann
Ananias Nusæ | Ludomilla Krumblowski
Mattheus Fleischer | Rebecca Triebler
Wolf Georg Ritter | Anna Magdalena Becher
Barthel Albrici | Maria Atrilen?
Sebastian Gottfried Starcke | Sophia Christina Weller
1658
Hans Adolph Haugwitz | Catharina VomEnde
Caspar Siegmund Berbisdorf | Magdalena Sybilla Kostbot
----------------
Wolf Siegmund Hartitzsch | Anna Elisabeth Breltau
Jeremias Knorr | Regina Voigt
Georg Löbe | Sophia Drübler
Caspar Heinrich Schonberg | Dorothea Agnes Taube
Christoph Schafler | Euphrosina Maria Tenzel
Elias Rehpolt | Concordia Graf
----------------
1659
Balthasar Seidenecken | Anna Margaretha Erdman
Gottfried Wolffersdorf | Anna Elisabeth Pflüg
Caspar Thieme | Emilia Jocker
Jobst Christoph Dritzschler | Anna Elisabeth Rechenberg
Christian Mohr | Maria Huber
Wolfgang Voigt | Maria Ziegeldecker
Johann Wolfgang Schadard | Anna Müller
Sebastian Ludwig Sulze | Johann Martin Husan
----------------
Tobias Tille | Magdalena Sybilla Kittel
Hans Paul Schilling | Regina Elßnizer
Johann Friedrich Heigi | Anna Margaretha Findekeller
Joachim Heinrich Ziegeser | Regina Salome Allenbeck
Christoph Bernhardi | Christina Barbara Weber
Leonhard Albhard | Ursula Christina Findekeller