Dresden Hofkirche (Buch 22)
Trauungen 1827-1857
https://data.matricula-online.eu/de/deutschland/dresden/dresden-hofkirche/22/?pg=1

Das ist ein einfacher Index aller Trauungen
Die Schreibweise der Namen entspricht nicht immer der Schreibweise im Buch.
Zusätzlich ist das Kirchenbuch nur schwer lesbar und viele Namen exotisch, oft unklar und lateinisiert.
Die Fehlerquote in diesem Index ist recht hoch.


Erstellt mit Unterstützung durch KI
August 2024
https://github.com/tintenfrass/simplechurchbookindexes



---------------- x4
1827
Carl Kühnel | Christiana Rosina Peter
Johann Neugebauer | Eleonora Christian Pomsel
Johann Benjamin Einsdorf | Maria Josepha Gibili
Johann Heinrich Ebat | Catharina Frohberg
Anton Pomes | Barbara Kadelmayer
August Horack | Eleonora Sophia Pohle?
Johann Gotthelf Junknickel | Josepha Nels
Moritz Edlinger | Agnes Ernestina Zimmer
----------------
Andreas Strietzel | Amalia Hetze
Paul Verderber | Maria Rosina Klahre
Christoph Fritzmann | Johanna Beata Franke
Wilhelm August Braune | Christiana Carolina Kaden
August Milde | Eleonora Augusta Kersch
Friedrich Ludwig Drescher? | Maria Christina Koppelt
Johann Wilhelm Schneider | Johanna Christiana Horak
----------------
1828
Thomas Marischler | Anna Dänichen?
Gottlob Hassmann | Eva Rosina Mittag
Heinrich Christian Friedrich Kreisig | Charlotte Louise Reinhart
Anton Groß | Christaine Wilhelmina Schmiedger
Johann Adam Scherz | Johanna Christina Lehmann
Joseph Hacke | Magdalena Leschbor
Ernst Gottfried Semler | Johanna Henriette Pree
Heinrich August Kobel | Walburga Schmiedel
----------------
Georg Layern | Juliana Carolina Toote
Nicol Donat | Julien Elisabeth Rehmann
Sebastian Peter Schüffeny? | Wilhelmine Dorothea Castelli
Joseph Kastalli | Caroline Lasenmata?
Joseph Lindel | Louise Titel
Carl Gotthelf Gerster | Adelheit Peschel
Andreas Schauer | Wilhelmine Gürtler
Christian Friedrich Linder | Maria Elisabeth Schröedel
----------------
Gustav Simon Wagner | Maria Apollonia Kümmeln
Vinzenz Schibitzky | Josepha Christiena Dichter
Johann Christian Hauswald | Amelia Hofrichter
Carl Ignatz Stockwert | Amalia Lehnert
Carl Andreas Gauck | Juliana Wilhelmine Wehmeyer
Heinrich Fürchtegott Müller | Johanna Auguste Möckel
Peter Ferdinand Fürstenau | Augusta Louise Sidonie Herrmann
----------------
Christian Gottlieb Schumann | Anna
Carl Eduard Köhler | Josephina Hummel
Johann Christian Ferdinand Karl | Theresia Perstorfer?
Johann Gottfried Schmidt | Carolina Wilhelmina Schlechter
Joseph Patzelt | Anna Christina Ehrich
Georg Wilhelm Andreas Sieber | Christiana Juliana Hubert
Nicol Schulze | Theresia Franziska Richter
Franz Obermayer? | Cristina Sophie Jahnig
----------------
Bergislav? Hellmuth Mahlzahn | Cavelina Elisabeth Amaliea Theresia Julia Kray
Wilhelm August Strauß | Henriette Marie Kaufmann
Julius Alexander Theodor Friedrich August Brochowsly | Maximiliana Elisabeth Ende
Carl Wilhelm Eduard Naumann | Adelheid Augusta Carolia Richter
Johann Gottlieb Leberecht Fritsche | Antonia Augusta Weingert
----------------
Carl Rudolph Sack | Caroline Ernestine Sack
Peter Comte | Angelika Elisabeth Louise Delipine
Johann Gottlob Fehrmann | Magdalena Theresia Liebisch
Joseph Pollack | Johanna Sophia Werner
Georg Duzz? | Christiana Rosina Müller
Carl Luricelli | Augusta des Joseph Choulart
Johann Schneider | Johanno Concordin Augusta Böhme
----------------
Gottlob Friedrich Sommerschuh | Henriette Mariana Mann
Heinrich Moritz Birnbaum | Ida Cacilia Ludovika Klotz
Carl Moritz Nostitz | Wilhelmina Tümptling
----------------
Carl Würfler | Johanna Friedrika Eleonora Reinitz
1829
Carl Kremße | Maria Wooke
Joachim Hermann | Auguste Wilhelm Knabe
Anton Buzzi | Louise Kalch
Erdmann Petri | Marie Margaretha Schäfer
----------------
Joseph Rudel | Johann Sophia des Peter Neumann
Leonhard Mantel | Amalie Auguste Schäfer
Johann Carl Seidel | Johanna Dorothea König
Johann Friedrich Müller | Johanna Magdalena Schwabe
Albert Böhme | Anastasia Petronella Stein
----------------
Christian Friedrich Hempel | Maria Anna Pazgal
Carl Joseph Sanius | Johanna Chriana Pomp
Dionys Schmidt | Johann Caroline Burkhardt
Johann Gottfried Barthel | Maria Theresia Poranz
----------------
Gustav Friderici | Henriette Augusta Feullner
Carl Gottlieb Neuhäuser | Katharina Rosalie Partzner
Carl Hermann Bünger | Marie Sophie Mathilde Hasslauer
Joseph Römer | Johanna Wilhelmina Hennigk
----------------
Carl Wilhelm Schönberg | Johanna Eleonora Löbel
Aloys Johann Pawlicowsky | Maria Magdalena Beck
Bernhard Ulbrich | Maria Anna Brückner
Franz Zeller | Agnes Mathilde Martin
Karl Hermann | Franziska Veronica Langebach
----------------
William Michael Mayer | Johann Rosina Stephan
Christoph Mohr | Katharina Hartman
Johann Gottlieb Daubitz | Bertha Marianna Gutkäs
Johann Christoph Lange | Katharina Teuchert
Alexander Tridon | Carolina Franziska Sattler
----------------
Johann Gotthelf Dietze | Clara Kommernitztky
Nicol Nischporg | Johanna Christiana Kühnel
Georg Voll | Johanna Dorothea Börner
Heinrich Eduard Hamann | Camilla Maria Babbi
----------------
1830
Ludwig Benjamin Rieffel | Albertina Sidonie Antoinette Helbig
Carl Ernst Günther | Josepha Bitschowsky
Franz Ebert | Concolina Schmettgen
----------------
Anton Bratschädl | Marie Amalie Henrichte Garden
Johann Samuel Huhle | Johanna Heinrich
Friedrich Richter | Christiana Hauffe
August Joseph Rieffel | Paulina Maria Dermann
Friedrich Prellermax | Johann Caroline Wilhelms
----------------
August Wilhelm Weichert | Josepha Stachel
Georg Welling | Carolina Künicke
Joachim Braun | Ernestine Stange
Christian Eduard Zscheuche | Friderica Augusta Wollmar
----------------
Bernard Wustro | Catharina Schmidt
Franz Brendler | Aurgusta Wilhelm Schmid
Christian Gottlieb Schmidt | Juliana Löhnert
Carl Franz Lubech | Louse Mathilde Hermsdorf
Joseph August Seillern | Antonia Dedo
----------------
Carl Johann Friedrich Franke | Charlotte Amalia Brügner
Joseph Laßman | Caroline Wilhelmina Erler
Johann Anton Burchert | Johanna Christiana Buchda
Ernst Ferdinand Wiesehügel | Dorothea Becker
----------------
Moritz Friedrich Eduard Käufler | Ernstina Hottenroth
Franz Krist | Magdalena Katzer
Heinrich August Weber | Agnes Renschke
Karl Eduard Puntzelt | Josepha Salzer
Joseph Riha | Amalie Christina Bergman
----------------
Gottfried Lohrie | Johanna Theresia Redlich
Anton Meitele | Juliana Porstendorfer
Johann Anton Haschke | Wilhelmina Kranhold
Johann Jacob Caraß | Elisabeth Hetze
Wenzel Lang | Magdalena Susanna Fleischer
Joseph Buchli | Christiane Carolina Förster
----------------
Johann Heinrich Bamberger | Amalia Schecks
Anton Weiß | Josepha Kowalska
Johann Anton Trenkler | Dorothea Schubert
Carl Friedrich Siebert | Emilie Blümel
Gerhard Klöster | Amalie Wagner
----------------
Franz Blümel | Caroline Siebert
1831
Johann Martin Vogelgesang | Anna Eyben
Christian Zimmermann | Auguste Schneider
Karl Gotthold Schönherr | Dorothea Sarlazech
----------------
Franz Weigel | Franziska Spann
Franz Micoßi | Clara Ludmilla Becker
Gilavius Stybinski | Auguste Sommer
Joseph Berna? | Marie Theresia Prée
----------------
Joachim Vestri | Natalia Christiana Bohlig
Carl Heinrich Weise | Anna Rosina Ottmaschill
Carl August Dachsel | Johann Ottili Jahn
Ludwig Schmidt | Aloysia Aulitz
Johann Bauer | Christiana Juliana Fickert
----------------
Franz Adolph Nicol Piper | Josepha Theresia Christina Apollonia Eckard
Christian Vogel | Carolina Schnee
Johann Leonard Schurk? | Katharina Neuman
Karl Agsten | Maria Friederica Völkner
----------------
Ernst Carl Kaßel | Wictoria Carolina Fränkel
Franz Anton Vogel | Sophie Fassmann
Franz Heinrich Kulisch | Johanna Christiana Müller
Wilhelm Luter | Wierzerzin? Wikart
----------------
Anton Malkisch | Maria Koch
Johann Gmeiner | Sophie Armalia Mauerman
Georg Franz | Henritte des Christian Schiffer
Paul Ramutia? Pesadori | Antonie Pechwell
Karl Heinrich Schneider | Christiana Emilie Schlechter
----------------
Wilhelm Andreas Schekcs | Maria Thersia Spiegel
Karl Friedrich Ziegler | Caroline Schothe
Friedrich Benedikt Schneider | Maria Josepha Juliana Krütli
1832
Johann Lutherer | Charlotte Oehm
Mattheus Stuckel | Wilhelmina Rothleder
Carl Christian Spaarmann | Maria Voland
Alexander Ernst Sickritz | Eva Rosina Hohmann
Louis Kelleville | Eusebia Adriana Eyrand
----------------
Johann Schubert | Katharina Petarch
Johann Williard | Friederica Lunitz
Anton Luboiatzki | Augusta Sende
Johann Eduard Kulisch | Dorothea Friderica Bär
Nicol Waurich | Franziska Delas
----------------
Johann Otto | Maria Magdalea Leimer
Johann Pichler | Maria Theresia Kliemann
Franz Engelschall | Josepha Friederica Richter
Johann Kirchknopf | Friederica Siegert
Johann Gottfried Anton Eichler | Joh. Augusta Theresia Weisse
----------------
Karl Richter | Theresia Sommer
Johann Taschenberger | Agnes Raabe
Heinrich Geißler | Christian Dorthea Liebezeit
Christian Friedrich Baumgarten | Maria Theresia Schneider
Joseph Casorti | Elisa Spetterino
----------------
Franz Krabansky | Maria Teubel
Angelo Borrini | Caroline Josephine Louise Kredik
Carl Anton Rößner | Marie Theresia Giepilli
Johann Keppler | Johann Neunert
Friedrich August Richter | Johanna Henriette Winkler
Michael Hedan | Maria Emalie Koppke
----------------
August Troll | Maria Theresia Böhm
Heinrich Otto Weyel | Henriette Adolpha Schwarz
Xaver Sapicka | Constantina Soblaska
Johann Friedrich Hajeck | Louis Sedelmayer
----------------
Joseph Franke | Josepha Wenzel
Gotthelf August Fielitz | Friederica Amalie Walther
Armand Simon Cubiekes | Isbella Masia Baudissin
----------------
1833
Franz Eduard Kögel | Maria Anna Fahlbusch
Carl Robert Blaß | Augusta Wilhelmina Mensch
Gottlieb Friedrich Jacob | Maria Anna Aloysia Frenzius
Johann Gottfried Schreiber | Maria Amalia Bratschädel
Maximilian Lauch | Johana Christiane Huhn
----------------
Friedrich Ernst Sonntag | Anna Dorothea Peterka
Georg Balzer | Maria Mucha
Eduard Friedrich Junig | Henriette Zschallig
August Buhr | Johanna Strumpf
August Ludwig Robert | Margarethe Dorothea Elisabeth Wittenberg
----------------
Joseph Plewka | Theresia Hentschel
Joseph Richter | Amalia Schrödels
Eduard Böhme | Lerpoldina Emilia Liebezeit
Johann Ernst Kästner | Carolina Peter
----------------
Friedrich Sachsen | Maria Bayern
Nicol Waurick | Christiane Caroline Benewitz
Carl August Engelhardt | Anna Kürzendörfer
Anton Pohl | Johanna Rosina Müllerstein
----------------
Hermann Günther Meynert | Maria Emmering
August Horack | Juliane Fischer
Carl Gottlob Seidel | Christiane Marie Therese Werner
Johann Daniel Starcke | Marie Vogel
Carl Görlach | Charlotte Mathilde Braun
----------------
Johann Traugott Leberecht Börner | Marie Josepha Franziska Schernack
Jacob Schneider | Ursula Petsch
Carl Faulwaßer | Magdalena Queiser
Julius Benno Böhme | Johanna Eleonona Charitas Estler
Carl Daniel Gotthelf Päbler | Marianne Barbara Heine
----------------
Christian Gottlieb Fielder | Maria Theresia Carolina Fränzel
Joseph Franz Reimann | Christiane Juliane Charlotte Mitlacher
Friedrich Eduard Sommer | Marie Börner
Hermann Wilhelm Schumann | Marianne Pauline Riedrich
Anton Stöber | Johanne Sophie Piessner
----------------
Carl Heinrich Geisler | Marie Dorothea Michaëlis
Gottlob Richter | Franziska Amalia Antonia Lissau
Gottlieb Friedrich Zanger | Christiane Catharina Becker
Otto Alexander Neumann | Franziska Maria Ziesky
----------------
Stanislaus Pradowsicki | Anna Babbi
1834
Joseph May | Ida Lorbacher
Gustav Heinrich Warnatz | Theresia Christiana Barbara Maria Richter
August Friedrich Pfund | Charlotte Louise Schmidt
----------------
Friedrich Anton Mathes | Johanne Charlotte Köchel
Johann Knoche | Marie Magdalena Schnöbel
Andreas Siebert | Theresia Werner
Carl Joseph Smeckal | Willhilmine Auguste Richter
----------------
Christian Xaver Weingärtner | Alwine Juliane Auguste Fritsche
Gotthelf Friedrich Drechsel | Amalie Sophie Rosine Pfützner
Sebastian Pruckmayer | Auguste Ernestie Schädlich
Andreas Adolph Franz Hübner | Christiane Juliane Walter
----------------
Michael Och | Elisabeth Miecksch
Carl Friedrich August Sperrhaken | Maria Christiane Richter
Ernst Albert Gottschalk | Marie Neumann
Gottlob Heinrich Voigt | Aloysia Anderfuhr
----------------
Wilhelm August Heineck | Cäcilie Henriette Wolf
Clemens Philip Weidner | Maria Barbara Kohlhase
Johann Wilhelm Helfer | Mathilde Pauline Granges
Carl Gottlieb Hörnig | Magdalena Robel
----------------
Johann Christian Opitz | Louise Barbara Lorenz
Ludwig Gottlob Castelli | Amalie Mathilde Mannchen
Lorenz Bayer | Francisca Zech
Johann Buck | Johanna Eleonora Ludewig
----------------
Anton Stoll | Marianne Duc
Gotthelf Jonas | Maria Theresia Gützel
Carl Friedrich August Heinrich | Rosalia Francisca Rosengarth
Franz Christoph Schmidt | Johanna Carolina Gast
----------------
Johann Wilhelm Schubert | Henriette Louise Köhler
Johann August Meißner | Erdmuthe Juliane Hähnichen
Carl August Friedrich Schäfer | Christiane Sophie Börner
Friedrich August Gutdorf | Catharina Georg Brückner
----------------
Ernst Ferdinand Glück | Johanna Augusta Müller
Johann Gottlob Anders | Amalia Theresa Hubert
Johann Gottfried Günzel | Theresia Jängen
Johann Heinrich Völlmicke | Maria Anna Magdalena Weiss
----------------
Friedrich Wilhelm Koch | Johanne Henriette Olschar
Joseph Brunner | Johanna Marianna Köppler
Carl August Hauptmann | Antonie Hoffmann
Conrad Leopold Alexander Opitz | Maria Josepha Cantin
----------------
1835
Carl Moritz Anton Sommer | Emilie Galle
Johann Gottlieb Schubert | Josepha Maria Theresia Rothe
Carl August Nebel | Juliane Fischer
Anton Aloys Spann | Anna Maria Sibilla Josepha Deynet
----------------
Joseph Sell | Maria Josepha Agnes Seiffert
Anton Dziembowski | Louise Anette VitzthumEchstadt
Johann Weis | Philippine Stachel
----------------
Carl Storremberg | Elisabeth Maria Esser
Maximilian Joseph Christian Bonniot | Marianna Dominica Malinverno
Johann Vinzent Anton Ruppert | Amalia Augusta Hartler
----------------
Johann Haustein | Maria Lasky
Ferdinand Adolph Hörnig | Antonia Constanze Carolina Pusinelli
Johann Georg Rubel | Anna Maria Liebsch
Carl Gottlob Schädler | Christiana Schimmel
----------------
Jacob Nätzsch | Johanna Augustus Bartsch
Albert Maximilian Hottenroth | Amalia Krobicka
Otto Arthur Langenn? | Pauline Marie Julie Brochowski
----------------
Friedrich August Mathes | Friederica Antonia Helfer
Johann Friedrich Martin Weber | Carolina Walther
Xaver Joseph Knieling | Maria Juliana Schmidtgen
----------------
Carl Kämmerer | Emilie Christiane Eleonore Märker
Friedrich Adolph Schlimpert | Juliana Amalia Schneider
Franz Jentsch | Johanna Christiana Friederika Wolf
Johann Sebastian Thaler | Emilia Walcha
----------------
Friedrich Eduard Müller | Johanna Pauline Juliana Hornfeld
Johann Gottlob Kästner | Christiane Friederik Blum-Rosenthal
Carl Ludwig Köbitz | Dorothea Christiana Schömel
Johann Joseph Thiele | Christiana Amalia Stange
----------------
1836
Friedrich Schmidt | Catharina Wittmann
Johann Bohlig | Antonia Amalia Mayerhof
Michael Rubel | Anna Mros
Carl August Ullmann | Johanna Marianna Breuer
----------------
Johann Herrmann Athens | Maria Catharina Hildebrand
Sebastian Lehmann | Anna Jorsch
Friedrich Wilhelm Lottenburger | Josephine Willhelmine Hübner
Joseph Kündiger | Clementine Fröde
----------------
Christian Gottlieb Meyer | Aloysia Regina Distler
Friedrich Wilhelm Menzel | Maria Theresia Augusta Schöppe
August Heinrich Liebeskind | Ida Louise Goehter
Johann Gottfried Heinze | Agnes Klammer
----------------
Mattheus Schuster | Maria Spittang
Jacob Friedrich Aloys Richter | Christiane Henriette Löwe
Carl Gottfried Burckhart | Johanna Sophia Beuchling
Martin Kutschardt | Catharina Schulze
----------------
Friedrich August Focke | Florentina Josepha Willhelmina Gerbing
Carl Friedrich Fischer | Friederike Sophie Ostler
Anton Eduard Scheinpflug | Johanna Sophia Dresko
----------------
Gustav Lorenz Röder | Johanna Christiana Knab
Caspar Joseph Dürck | Laura Antonia Kistner
Joseph Heinrich Kirchel | Johanna Paulina Agnes Kuhnert
----------------
Franz Ludwig Hammel | Christiene Aophie Säuberlich
Christian Carl Philip Snell | Pauline Henriette Voland
Carl Friedrich Schwanert | Johanna Christiana Kulckan
----------------
Johann Samuel Herkules Torniamente | Mathilde Füssel
Friedrich Wilhelm Haustein | Maria Johanna Friederika Weserling
Joseph Wenzel Löbel | Juliane Rahel Emilie Wittig
----------------
Bernhard Vinzenz Kindermann | Juliana Dotzauer
Balthasar Lindner | Christiane Juliane Gerisch
Heinrich Gottlob BürcknerPlödterl | Liddi Adelaide Müller
----------------
Carl Gottfried Philipp | Johanna Löbel
Friedrich Wilhelm Nolte | Christiane Sophie Lesche
Georg Friedrich Koch | Maria Josepha Pabst
----------------
Paul Müller | Carolina Leunert
Heinrich Moritz Martini | Pauline Schubert
Friedrich August Tauchert | Carolina Augusta Wenzel
----------------
Carl Eduard Schultze | Friederika Amalia Grassenburg
1837
Carl Franz Werner | Maria Clara Ludmilla Becker
Nicol Bensch | Catharina Lassig
----------------
Carl Julius Pezold | Wilhelmine Caroline Pizcinetti
Johann Christian Andreas Schotte | Maria Johanna Kühnel
Christian Ehrenfried Seyfert? Tennecker | Franziska Maxmiliana Theresia Thümmel
----------------
Johann Gottfried Stolle | Anna Budar
Carl Friedrich Ludwig | Auguste Henriette Koschel
Nicol Katzer | Gertrud Lehmann
----------------
Friedrich Moritz Joseph | Anna Duchand
Heinrich Adolph Baßenge | Maria Anna John
Franz Wenzel Fiebiger | Ida Rosina Hofmann
----------------
Johann Carl Gottfried Willhelm | Marianne Urbann
Gottlob Carl Leonhardt | Marie Anna Renner
Paul Dusaux | Caroline Concordia Mathilde Schmidt
----------------
Johann Kretsch | Antonia Josepha Meissner
Carl Friedrich John | Maria Amalia Charlotte Franz
Johann Baptist Georg Christian Schwegerle | Augusta Maria Natalia Jacob
----------------
Johann Wilhelm Ludwig Tschudi | Maria Anna Magdalena Naumann
Carl Eißner | Elisabeth Anastasia Morasch
Franz Anton Schubert | Maria Heinriette Schneider
----------------
Anton Christian Joseph Greif | Juliane Adelheid Taschenberger
Johann Metk | Johanna WillHelmine König
Alexander Elias Maximilian Ostrowski | Juliane Emilie Merkel
----------------
Ernst Ferdinand Heinrich Dohmann | Auguste Emilie Adelheid Wollmann
Johann Gottlob Friedrich Heinrich Hanke | Juliana Franziska Reiche
Johann Georg Adler | Juliana Theresia Rauwolf
----------------
Johann Nepomuk Mengemann | Adelheid Bertha Fischer
Heinrich Moritz Leiter | Johanna Eleonora Bartzsch
Franz Xaver Fiedler | Johanna Sophia Leuschke
----------------
Carl Heinrich Möbius | Franziska Maria Anna Hildmann
Friedrich Gotthold Neubert | Maria Magdalena Wuschansky
Carl Friedrich Gustav Otto | Marianna Josepha Aloysia Tietz
----------------
Christian Gottlieb Voigt | Maria Auguste Theresia Josepha Bothe
Lorenz Ebert | Christiane Dorothea Sophie Schmidt
Gottlieb Carl Heinrich Funke | Ida Grossmann
----------------
Carl Friedrich Weniger | Anna Johanna Maria Wander
Franz Heinrich Friedrich Bedon | Christiana Ernestine Gräblinger
Johann Carl Gottlob Gebhardt | Johanna Valk
----------------
Johann Markert | Carolina Augustus Müller
Johann Carl Friedrich Eichler | Maria Magdalena Hantzikin
Franz Eduard Schrutz | Maria Anna Theresia Wiedemann
----------------
Johann Katasowski | Maria Dorothea Leuteritzin
Friedrich Eduard Eller | Augusta Amalia Herld
Carl Gottlob Kleeberg | Eva Henriette Emilie Schmidt
----------------
Ludwig August Lehn | Louise Juliane Theresie Loebel
Friedrich Ehregott Herschel | Christiane Rosine Wasserling
Johann Jacob Groh | Eva Rosina Bettmann
----------------
Johann Joseph Krabansky | Johanna Rosina Pabst
Johann Gottlob Richter | Catharina Wenk
Carl Wilhelm August Moritz Gärt | Theresia Antonia Carolina Maria Tümpling
----------------
Franz Anton Lorgi | Amalia Theresia Etzold
Johann Wilhelm Ernst Kräblin | Marianna Alter
Johann Franz Immanuel Liebert | Antonia Theresia Loebel
----------------
Nicol Brühl | Christiane Eleonora Ullrich
1838
Anton Georg Stauber | Dorothea Elisabeth Hentschel
Georg Zaude | Christiane Elisabeth Leopaldine Loebel
----------------
Johann Gottlieb Grumpelt | Marie Therese Götz
Karl August Moritz Rentzsch | Elisa Schmidt
Friedrich Christoph Franz Künzel | Maria Karolina Neckar
----------------
Friedrich August Kunze | Anna Buder
Ernst Adolph Craushaar | Antonie Fanny Puteani
Johann Gottlob Jähnel? | Amalie Auguste Bassler
Joseph Friedrich August Hahn | Maria Anna Gaipl
----------------
Karl Gottlieb Kannegieser | Maria Theresia Luckass
Joseph Tachowsky | Maria Pilack
Karl Gottlieb Löschner | Christiana Katharina Lipsch
----------------
Theodor Haushalter | Anna Franziska Lenz
August Salomon Leberecht Weiner | Johanna Friederika Schulze
Ludwig Moritz Schwartz | Christiana Friederika Valtin
----------------
Christian Heinrich Schmidt | Christiane Eleonora Stange
Friedrich Gottlieb Aster | Apollonia Laufer
Johann Gottlob Klöpel | Rachel Sibylle Bercka
----------------
Nicol Thomann | Johanna Christiane Thoman
Traugott Friedrich Fischer | Maria Antonia Amalia Bercka
Anton Ferdinand Karl Zacharias Staszewski | Anna Emilia Weiss
----------------
Gottlieb König | Johanna Lorenz
Hermann Theodor Peter | Marie Theresie Londershausen
----------------
1839
Timotheus Matwejew Schigali | Johanna Anna Roybar
Johann Gottlieb Müller | Johanna Christiana Hofmann
Johann Otto Klingkowski | Amalia Augusta Eisold
----------------
Johann Ammerich | Christiane Friedericke Naumann
Johann Zimmer | Maria Dzisswauk
Johann Pinzel | Katharina Nowack
----------------
Peter Juhr | Agnes Czech
Leberecht Ferdinand Leopold | Anna Katharina Eyben
Peter Anton Comte | Marie Margaretha Laurentia Vaudeaux
----------------
Franz Anton Scheib | Christiana Sophia Franke
Heinrich Ferdinand Rusch | Johanna Elisabeth Heine
Franz Hopfe | Henriette Clementine Mathilde Lahode
----------------
Karl August Melke | Anna Dorothea Wels
Johann Gottlieb Kretzschmar | Amalie Augusta Emilie Effenberger
Vinzent Paustka | Juliane Regine Zesewitz
----------------
Franz Hornich | Katharina Mischmnar
Karl Gottlob Jähnel | Karoline Sophie Schuppan
Peter Joseph Ammerich | Franciska Blummer
----------------
Karl Gottlieb Richter | Juliana Marianna Katharina Micksch
Johann Gottlieb Zeibig | Anna Juliana Barbara Raabe
Karl Heinrich Leibelt | Maria Anna Krahl
----------------
Johann Gottfried Eduard Krüger | Maria Theresia Adelheid Meisinger
Ernst Eduard Müller | Maria Torma
Johann Ludwig Arlt | Karoline Agenes Klitschka
----------------
Franz Heinrich Anton Sachwald | Amalia Karolina Dorothea Mildenberger
August Joseph Wilhelm Eslauer | Amalie Willhelmin Grosser
Friedrich Wilhelm Dreyßig | Theila Gaebler
----------------
Franz Dunkel | Clara Henriette Stoll
Ernst Julius Hähnel | Maria Anna Elisabeth Löb
Ferdinand Carl Jenzsch | Willhelmine Amalie Rentzsch
----------------
Salvador Pereira | Maria Theresia Kochtizka
Johann Gottlob Wilhelm Sachse | Anna Böhme
Carl Otto Ludwig Poschwitz | Maria Apollonia Jaenchen
----------------
Anton Franz Hübner | Carolina Hedwig Büttner
Michael Sauer | Anna Cziesch
Johann Baptist August Lequin | Rosina Maria Babet Hemmann
Jacob Kroh | Henwirzte Emilie Berich
----------------
Friedrich Wilhelm Gerlach | Marianna Schwarz
Carl Ludwig Schumann | Antonia Charlotte Gersnikow
Eulogius Thaddäus Joseph Leonard Zakirzewski | Clementina Johanne Apollonie Zakirzewski
----------------
Friedrich August Anton Weinicke | Henriette Marie Sophie Kremmler
Peter Alexander Weingärtner | Caroline Friderike Wilhelmine Meutzner
Carl Gottlieb Freyberg | Christiane Elisabeth Caroline Kiesling
----------------
Friedrich Wilhelm Hellwig | Wilhelmine Procksch
Hans Heinrich Ludwig Pückler | Juliane Augusta Mathilde Zobel
1840
Friedrich Bayer | Sidonia Mathilde Karolina Helbig
----------------
Friedrich Kamillo Janßen | Demoiselle Maria Schreiner
Johann Karl Gottlob Oesen | Johanna Schiffner
----------------
Johann Gottfried Billig | Amalia Willhelmine Hübler
Joseph Keßler | Hermine Adolphine Barthel
----------------
Nicol Siemank | Amalie Dorother Schneider
Ernst Otto Nätsch | Amalia Karo lina Malles
Jacob Heduschka | Christiana Friederika Arnert
----------------
Johann Georg Adler | Franziska Zeitler
Karl Robert Fischer | Maria Brophy
----------------
Sebastian Vowinkel | Auguste Willhelmina Hofmann
Jacob Kretzschmar | Johanna Rosina Poyda
Johann Friedrich Wilhelm Baptist Klöber | Maria Karolina Amalia Christophani
----------------
Ferdinand Leile | Christiana Amalia Stumpf
Karl Theodor Alexander Bose | Henriette Elisabeth Lucia Borsum
Karl Wilhelm Clemens | Amalia Augusta Demuth
----------------
Karl Friedrich Ender | Veronika Hiebsch
Joseph Anton Ignaz Bittner | Veronika Wolf
----------------
Friedrich Schreiner | Maria Juliana Amalia Strasser
Joseph Albert Loebl | Maria Theresia Kösser
Johann Albrecht Siebert | Eleonora Amalia Karich
----------------
Michael Stärz | Maria Josepha Schich
Heinrich Bernhard Schier | Ottilie Josephine Henriette Preil
Gottlob Heinrich Dinter | Maria Magdalena Petruscha
----------------
Johann Karl August Schorp | Friderike Wilhelmina Sticht
Johann Nepomuk Erdödy | Therese Raczynska
----------------
Johann Karl Moritz Halm | Maria Dorothea Elisabeth Otto
Anton Alexander Staszewsky | Amalia Charlotte Merker
Karl August Müller | Johanna Christiana Amalia Hoffmann
----------------
Georg Jacubasch | Maria Magdalena Klimant
Gustav Eduard Liegel | Maria Anna Augusta Schmidt
Eduard Karl Anton Johann Gottfried Gottlob Friedrich Hironimus Manfroni | Christiana Charlotte Patau
----------------
Michael Starz | Johanna Friederika Beata Schubert
Johann Martin Uter | Johanna Rosina Hase
August Michael Charlier | Thusnelde Koritz
----------------
Johann Karl Gottlob Hermann | Amalie Franziska Biegert
Johann August Reinhold Richter | Maria Anna Louisa Agnes Peters
Johann Kosciatkowski | Anna Siesicki
----------------
Anton August Gablenz | Amalia Friederika Augusta Lützerode
----------------
1841
Anton Georg Mitterwurzer | Henriette Herold
Johann Friedrich Leberecht Wolf | Maria Magdalene Hempel
----------------
Friedrich David Eduard Stryck | Franziska Ludmilla Hinke
Johann Schittelkopf | Minna Agnes Hickardt
Peter Sende | Anna Lehmann
Johann Andreas Parner | Augusta Wilhelmina Wiegner
Nicol Wortscherk | Johanna Rosina Thieme
----------------
Friedrich August Hellriegel | Marie Anna Weigel
David Andreas Berkemmer | Maria Caroline George
Michael Alexander Lehmann | Anna Maria Liepsch
----------------
Franz Friedrich Böhnky | Christiane Karoline Wilhelm
Franz Anton Thiele | Anna Maria Theresie Uder
Friedrich Wilhelm Moritz Schneider | Marie Josephe Sende
Carl Heinrich Brand | Christina Hedasch
----------------
Friedrich August Bersch | Johann Charlotte Heinicke
Oktavius Wenzel Tietze | Christiane Sophie Pabst
Carl Christian Meltzer | Caroline Auguste Behrens
Louis Ferdinand Nimsch | Theresia Braun
----------------
Carl Heinrich Jacob Bamberger | Maria Theresie Becker
Joseph Gustav Leiter | Josepha Anton Buzzi
Karl Joseph Lubeck | Maria Theresia Antonie Peters
----------------
Franz Ignaz Sommer | Charlotte Emilie Lucas
Johann Samuel Kranert | Amalie Emilie Kopfkuchen
Johann Joseph Küttel | Marie Louise Hasenwend
----------------
1842
Franz Vetter | Magdalena Nickel
Carl Oskar Xaver Lenz | Emilie Therese Eckhardt
Johann Christian Weigel | Johann Christiane Rönsch
----------------
Karl Ludwig Bahndorf | Auguste Eleonore Schneider
Friedrich August Hajeck | Louise Sedelmayer
Johann Samuel Karl Heyde | Maria Johanna Emilie Kiessling
----------------
Johann Baptist Ambrogio | Maria Pecci
Carl Friedrich Wilhelm Paul | Charlotte Louise Schöne
Johann Siegfried Schneider | Johanne Friederike Auguste Schaaf
----------------
Christoph Plater | Elisabeth Cissovska
Bernard Anton Robert Jacob Straus | Maria Anna Reÿ
Friedrich August Bernd | Anna Kockel
----------------
Carl Friedrich Otto | Pauline Petronilla
Franz Carl Anton Pusinelli | Caroline Bertha Chiappone
Samuel FestetitsTolna? | Wanda Raczynska
----------------
Karl Gustav Klemm | Thekla Gebel
Johann Joseph Geisler | Eva Henriette Marie Rehfeld
Jacob Liesche | Catharina Schula
----------------
Johann Gottfried Weber | Agnes Herrmann
Joseph Hermann Hoffmann | Maria Theresia Schubert
Georg Paulick | Johanne Dorothea Zomack
----------------
Carl Christian Huhle | Agnes Sende
Louis Franz Walcha | Johanna Katherina Elisabeth Gruber
Johann Friedrich August Barthel | Maria Dorothea Bode
----------------
1843
Heinrich Adolph Roscher | Julie Josephe Kurtze
David August Taggesell | Henriette Emilie Schneider
Johann Friedrich Ullrich | Bertha Mathilde Hasemann
Georg Schiepschick | Maria Schuster
----------------
Franz Kumpfe | Emilie Therese Wustmann
Johann August Krutzsch | Maria Anna Seckel
Johann Kallich | Magdalena Loebel
Peter Ließner | Friederike Wilhelmine Grützner
----------------
Joseph Anton Müller | Johanna Antonie Karoline Pauline Hand
Heinrich Julius Micksch | Theresia Caecilia Laurette Schoenberg
Johann Gottfried Rödig | Katharina Mathilde Josepha Koch
Gottlieb Robert Wimmer | Veronica Engel
----------------
Traugott Noack | Fraziska Adolphine Johanna Discant
Adolph Ruppelt | Karolina Auguste Willhelmine Langklotz
Andreas Richter | Hanna Sophie Taße
Anton Ludwig Fiedler | Rosalie Juliana Behr
----------------
Siegmund Corvin Crasne | Elisabeth Branicka
Karl Friedrich August Winde | Josephine Kruta
Karl August Würfler | Aloysia Hille
----------------
Georg Seifert | Agnes Busch
Friedrich Moritz Franz Berndorf | Julie Auguste Bauer
Karl Julius Große | Johanna Theresia Meyer
Friedrich Gustav Eduard Dorisch | Katharina Michel
----------------
Caesar Glater? | Stephania Marianna Vincentia Matachowski
Severin Grabowski | Sophia Aniuska?
Peter Jacob Anton Dallery | Maria Johann Caroline Amalie Aneck
----------------
Christian Heinrich Moritz Koch | Johanna Caroline Anton
Gottlieb Friedrich Schaab | Maria Eleonore Louise Wollmar
Gottlob Weißbach | Kunigunde Josepha Agnes Aloysie Thuma
Anton Franz Leiter | Wilhelmine Sophie Pietzsch
----------------
Johann Christoph Koitzsch | Johanna Sophie Antonie Weichhold
1844
Karl August Hübler | Johanna Christiana Schneider
Anton Woyciechowsky | Johanne Christine Glockauer
----------------
Albert Vincent Pittel | Isaline? Huguenin?
Traugott Wilhelm Mucke | Auguste Wilhelmine Seyffartt
Robert Adolph Heider | Auguste Christiane Amalia Laubisch
----------------
Peter Sarodke | Elisabeth Peter
Michael Delenka | Johanne Sophia Schmieder
Joseph Marischko | Anna Rosina Venuss
----------------
Friedrich Franz Max Borkmann | Amalie Therese Franziska Bister
Karl Ludwig Petasch | Christiane Juliane Wagner
Friedrich Maximilian August Jähnel | Christiana Friederike Gebler
----------------
Johann Nuck | Johanne Christiane Müller
Eduard Wilhelm Kühnel | Sophie Fischer
Anton Larti? | Marie Clementine Graebner
----------------
Johann Friedrich Hamm | Katharina Zschoch
Karl Leberecht Baumann | Christiane Pauline Sickritz
Nicol Busch | Magdalena Kubitz
----------------
Johann August Meißner | Amalie Concordia Sommer
Christian Gottlieb Lehmann | Maria Anna Arnold
Johann Gottlieb Erdmann Kirschner | Juliane Amalie Schlechter
Friedrich August Leopold Pree | Amalie Auguste Christiane Lange
----------------
Friedrich Maximilian Schmidt | Anna Maria Herbrich
Johann Anton K? Heinrich Barthel Hedde | Anna Waßiliewna Tschoukine
Johann Albert Meißner | Emilie Friederike Halffter
August Jäckel | Barbara Moudry
----------------
Joseph Dittmar Siegmund Nostitz | Mathilde Pauline Helfer
Johann Nicol Welsch | Anna Marie Hauptmann
Denis Aime Grare | Christina Marie Ernestine Longo
----------------
Moritz Donnel | Helena Cantacuzeno
Karl Friedrich Ferdinand Zimmermann | Juliane Wilhelmin Daxel
Johann Heinrich Ernst Langgemach | Johanna Katharina Klumsky
----------------
Georg Barsch | Josehe Haschke
Julius Francken | Wilhelmin Eleonora Karsten
Johann Franz Adolph Doliwa | Eustachia Ludovica Ayriaca? Brinska
----------------
Franz Robert Kühnelt | Christine Josephine Böhme
Carl Gottlieb Leuteritz | Anna Lebsa
Hermann Polycarp Jahn | Maria Weingärtner
Johann Merker | Johann Marianna Köppler
----------------
Franz Theodor Lönnig | Maria Anna Müller
Johann Friedrich Burkart | Sosphia Emilie Wilhelmin Hampsch
Friedrich August Lang | Johanna Juliana Hegewald
----------------
Hironimus Ludwig Liebscher | Hedwig Henriette Sachwall
Christian Martin Seyring | Amalie Christiane Seyffert
Georg Adolph Seelig | Johanne Christiane Henriette Dachsel
----------------
Karl August Ludwig Liebert | Saly Hermine Mathilde Leschke
Maximilian Anton Bendel | Christian Johanne Emilie Baumgart
Peter Anton Peltier | Adrienne Victoire Hue
----------------
Boleslaus Skirmund | Caroline Eufrasine Magdalena Skirmunt
1845
Vincent Skarzigski | Antoni Rembielinska
Carl Eduard Kawisch | Christian Charlotte Iffland
----------------
Julius Anton Carl Felicitas Johann Nepomuk Schubert | Emilia Augusta Schulz
Johann Carl Gottfried Martin | Maria Josepha Kirpal
Johann Friedrich Anton Merl | Johanna Maria Ludovica Amalia Staszewski
----------------
Heinrich Müller | Rosalie Amalie Josepha Bach
Johann Christoph Mroß | Maria Domsch
Carl Friedrich Kahleis | Rosalia Huban
----------------
Johann Joseph Pilz | Maria Anna Wenzel
Johann Martin Lutz | Franziska Theresia Fischer
Eduard Bernhard Pasig | Josepha Christiane Wilhelmine Horn
----------------
Franz Xaver Schramkofer | Johanna Christiana Bein
Karl Franz Ludwig Kergel | Maria Anna Lisinger
Eduard Stelzig | Johanna Maria Elisabeth Zusibach
----------------
Landolph Moritz Siegbert Gideon Ertel | Maria Christiana Zibaly
Nicol Wobsa | Auguste Wilhelmine Kirsten
Karl Gottlieb Wilhelm | Johanne Wilhelmine Hering
Johann Gottlieb Fehrmann | Josepha Wichenhagen
----------------
Gabriel Benjamin Krause | Julie Hübner
Johann Pilack | Maria Bräuer
Johann Friedrich Heinrich Bethmann | Rosine Tischler
----------------
Christian Voigt | Wilhelmine Bräuer
Carl Friedrich Biltz | Jungfrau Theresia Göpfert
----------------
1846
Carl Ferdinand Voigt | Josepha Böhme
Friedrich August Seifig | Johanna Barbara Büttner
Gottlieb Siegmund Götze | Hanna Kannicht
----------------
Michael Starz | Christiane Auguste Kmoch
Carl Georg Rühle | Ernestine Adelgunde Wilhelmine Bauer
Philip Christian Max Maria Weber | Catharina Huberta Kramer
----------------
Johann Gottlieb August Fülleborn | Maria Mitschke
Ferdinand Voigtländer | Johanna Emilie Elisabeth Schlechter
Carl Moritz Ehregott Förster | Laura Antonia Carolina Sickritz
----------------
Friedrich Joseph Arlt | Christiane Friederike Gerlach
Joseph Plewka | Apollonia Johanna Liebscher
Joseph Schellenberg | Johanne Friederike Sachse
----------------
Franz Weber | Amalie Barbara Scheithauer
Gotthelf Ernst Zänker | Theresia Rotter
Karl August Wilhelm Lange | Johanna Christiane Jähnel
----------------
Wilhelm Friedrich | Barbara Kirschner
Johann Kowz | Christiane Karoline Rentsch
Johann Karl Gottlob Schiller | Katharina Bulang
----------------
Karl Johann Walther | Wilhelmine Karoline Theresie Ulbrich
Johann David Dietze | Anna Otto
Friedrich August Mende | Clara Christiane Rothe
----------------
Johann Traugott Büttner | Katharina Barget
Adolph Moritz Binder | Christiane Rosine Heintze
Adolph Louis Oemky | Juliane Dorothea Egger
----------------
Franz Joseph Grohmann | Clara Augusta Wilhelmine Grahl
Andreas Kranich | Regina Peter
Carl Friedrich August Meßner | Amanda Henrika Theresia Schanzenbach
----------------
Franz Lußert | Henriette Margarethe Dauch
Friedrich Wilhelm Gaube | Maria Meitzner
Gustav Ludwig Jacob | Henriette Auguste Rentsch
----------------
Julius Hermann Deiss | Maria Elisabeth Koban
Franz Kühnel | Emilie Mathilde Bertram
Franz Louis Weber | Johanna Dorothea Hantschke
----------------
Moritz Ernst | Josephine Kaiser
Johann Christian Hempel | Maria Josepha Müller
August Georg Otto | Christiane Friederike Marie Fiebiger
----------------
1847
Franz Xaver Meißner | Friederike Henriette Grützner
Johann August Florian Ullrich | Johanna Christiane Schmidt
Moritz Ludwig Ignaz Potacki | Ludwika Bobr
----------------
Nicol Hille | Veronika Hartmann
Johann Franz Ignaz Suckow | Johanna Magdalena Scheufler
Anton Heinrich Wentzel | Josepha Böhme
----------------
Georg Jais | Katharina Wittmann
Joseph Ranhardt | Juliane Rosette Bachmann
Gustav Hermann Schlegel | Henriette Wilhelmine Herrmann
----------------
Johann Christian Werner | Maria Anna Auguste Franke
Anton Louis Heberlein | Maria Anna Leiter
Eduard Robert Neumeyer | Amalia Discant
----------------
Gregor Constantin Branicki | Hedwig Potocka
Karl Gottlob Stenker | Amalie Benedicta Kunigunda Ast
----------------
Franz Zöltowski | Sophia Zamoiska
Heinrich August Großmann | Agnes Leschbor
Julius Leopold Hermann Weiß | Rosalie Körpert
----------------
Friedrich August Liebscher | Antonia Czeck
Emil Adolph Gablenz | Caroline Auguste Catharine Preil
Carl August Kirsten | Rosa Amalie Franciscke Gerster
----------------
Franz Brendler | Dorothea Schüche
Friedrich Traugott Sachse | Elisabeth Franciska Schwarzbach
Adolph Louis Metzradt | Johanna Eleonora Elisabetha Pstross
----------------
Joseph Friedrich Poland | Maria Straßmann
August Joseph Ferdinand Buhr | Josepha Wöhle
Friedrich Carl Adolph Löschbor | Amalia Auguste Horack
----------------
Ludwig Adrian Roman Grangier | Marianne Louise Gros
Rudolph Hermann Manz | Johanne Wilhelmine Franke
----------------
Christoph Gottlieb Schachtlschabel | Wilhelmine Schunke
Mattheus Stiepany | Maria Müller
----------------
Franz Schlögel | Auguste Wilhelmine Schulze
Sebastian Vowinkel | Karoline Friederike Hofmann
----------------
Ernst Hugo Straßer | Philippine Payern
Johann Gottfried Winckler | Emma Augusta Heyder
----------------
Adam Joseph Mattheus Potocki | Catharina Branicka
August Julius Ferdinand Haase | Maria Hauptmann
----------------
Jacob Kramke | Johann Sophie Nake
Friedrich Carl Wilhelm Röse | Auguste Amalia Friederika Schubert
----------------
1848
Caspar Kahles | Emilie Wilhelmine Gebler
Franz Carl Kees | Johanne Friederike Schubert
----------------
Johann Gottlob Möbius | Magdalena Scholze
Robert Jacob Lehmann | Augusta Bünau
Johann Moritz Schäfer | Johanna Mattick
----------------
Pierre Francois Marie Joseph Adrien | Sophie Johanna Harder
Friedrich Wilhelm Lehmann | Helene Bartel
----------------
Emil Koch | Amalia Genovefa Koberwein
Wilhelm Moritz Muck | Maria Lepsa
----------------
Paul Kadner | Octavia Maria Mathilde Kles
Andreas Grülling | Auguste Christiane Caroline Hankel
Maria Joseph Emil Wuschanski | Rosalie Marie Anna Josepha Gerbing
----------------
Ernst Eduard Garten | Anna Maria Margaretha Gipilli
Wilhelm August Braune | Johanna Christiane Eckhardt
Albert Georg Müller | Amalia Maria Anna Sahler
----------------
Hans Carl Gustav Egidy | Maria Dauphine Bassenge
Gottfried Gustav Löffler | Caroline Fendrich
Johann Joseph Wialstofer | Wilhelmin Auguste Therese Kummer
----------------
Emil Boudet | Sidonie Caroline Freyberg
Karl Friedrich Anders | Anna Linke
Heinrich Albert Hermann | Johanna Steidle
----------------
Johann Gottlieb Fechner | Johanne Friederike Schneider
Karl Johann Ludwig Klug | Amalie Auguste Klug
----------------
1849
Carl Friedrich Jacob Preße | Marie Catharine Hantschke
Emil Hermann Carrinidi | Wilhelmine Hohenthal
Johann Joseph Redlich | Catharina Maria Rehork
----------------
Johann Gottlob Hoyer | Auguste Wilhelmine Krumbholtz
Andreas Franz Hübner | Klara Schellig
Carl Hermann Opitz | Elisabeth Willer
----------------
Johann Carl Liebenau | Anna Maria Theresia Mahling
Gustav Robert Müller | Magdalene Christiane Beckel
Karl Friedrich Neidhardt | Johanna Fiebich
----------------
Bernhard Heinrich Jodocus Mohr | Caroline Herriette Reischel
Michael Franz Pikarsky | Ernestine Karoline Walther
Carl Emil Süß | Caroline Emilie Nowotny
----------------
Franz Oskar Kreß | Demoiselle Franciska Pauline Eberl
Georg Sickritz | Marianna Tschiesche
Gustav Adolph Frauenstein | Anna Friederike Strassmann
----------------
Carl Friedrich Traugott Großmann | Ida Catharina Anna Sachse
Bernhard Leonhardi | Thekla Auguste Johanna Karolina Stiefel
Gotthold Friedrich Rosenblatt | Elisabeth Poppel
----------------
Karl Robert Fischer | Marie Auguste Antonie Nitzsche
Michael Holla | Agnes Beyer
Friedrich Wilhelm Hähner | Henriette Angelica Louise Amalia Riccarda Gebhard
----------------
Francois Hennequin | Anna Carolina Ludowika Barbara Longo
Karl Friedrich Bergfeld | Theresia Juliana Christiana Scheinpflug
Anton August Bürck | Marie Catharina Bayer
----------------
Ernst Ludwig Rasselt | Theresia Mick
Johann Christian Gottfried Schneider | Anna Petasch
----------------
Constantin Anton Parczewsky | Natalie Clementine Lipinski
Carl Johann Christian Lück | Maria Ida Pauline Schumann
Friedrich Michael Hartmann | Emilie Mäbert
----------------
Nicol Pech | Maria Waurenschk
Johann Ledzbor | Marie Therese Pollack
Carl August Berger | Marie Christiane Hering
----------------
Karl Friedrich Gey | Magdalene Lukass
Johann Gottlob Friedrich | Dorothea Theresia Kleinstück
Wilhelm Moritz Tischer | Amalia Maria Theresia Kaspar
----------------
Peter FalkenhagenZaleski | Maria Theresia Korzeniowska
----------------
1850
Karl Klodwig Carl Heinrich Friedrich Reilzenstein | Adelheid Maria Ludovika Mathilde Badenfeld
Carl Wilhelm Heinrich Tombo | Marie Magdalene Philippine Rudolphy
----------------
Carl Emil Schneider | Barbara Halmel
Johann Franz Philip Ludwig Berge | Auguste Wilhelmine Kunzmann
----------------
Johann Carl Gottlieb Goltzsch | Johanna Augusta Maria Müller
Karl Heinrich Grössler | Anna Rosine Hedwig Harmuth
----------------
Samuel Ehregott Dietrich | Magdalene Reichert
Ferdinand Sardinien | Elisabeth Sachsen
Karl Robert Rüdiger | Caroline Josepha Machilde Niedermeier
----------------
Joseph Adolph Wenschuch | Marie Sophie Werle
Karl August Miedke | Aloysia Anna Michalitzka
Johann Erdtel | Maria Schummer
----------------
Johann Gottlob Glörich | Julie Lindner
Johann Karl Kutzner | Anna Lottner
Nicol Fröhliger | Louise Charlotte Noack
----------------
Johann Christlieb Berrich | Anna Elisabeth Kzidowk
Johann Berg | Catharina Robel
Karl Anton Groß | Johanna Pauline Marie Schröter
----------------
Johann Franz Taute | Johanna Punline Marie Ludewig
Johann Traugott Leberecht Zeider | Karoline Louise Anders
Joseph Klepsch | Thekla Watzke
----------------
Johann Rentsch | Anna Hieblack
Georg Domann | Maria Amalia Bertha Grosser
Julius Anton Dunnebier | Emma Schuchardt
----------------
Georg Nuck | Johanne Christiane Richter
Jean Hellmich | Johanna Christiane Rothe
Christian Kölz | Theresia Werner
----------------
Carl Heinrich Edmund Peschel | Theresia Bayer
Ferdinand Emanuel Sieber | Juliena Katharina Weiß
Anton Woyciechowsky | Ernestine Agnes Singewald
----------------
Georg Betha | Christiane Petsch
Karl August Martin | Maria Schreiber
Carl Traugott Dietrich | Maria Anna Autonia Ruppensteiner
----------------
Johann Carl Gottlob Pankratz | Amalie Auguste Barth
----------------
1851
Franz Kumpfe | Marianne Cölestine Zinke
Michael Henrich | Maria Anna Lischka
Karl Hermann Weber | Amalie Braun
----------------
Johann Carl August Schonfeld | Marie Therese Einsdorf
Karl Adolph Kosche | Therese Petschwitz
Heinrich Wilhelm Geyer | Agnes Kubasch
----------------
Franz Lissmann | Caroline Friderike Karich
Carl Friedrich Joseph Stachel | Amalie Auguste Steglich
Ludwig Paul Adolph Kremmler | Amalia Weis
----------------
Carl August Robert Steidtlinger | Franciska Pieger
Johann Alois Berer | Marie Kremmler
Johann Peter Georg Helmstat | Antonie Pitschmann
----------------
Friedrich David Reppe | Anna Maria Gipilli
Christian August Mayer | Amalia Payert
Jacob Wocko | Catharina Jenke
----------------
Karl Friedrich August Schöne | Maria Scapan
Friedrich Benjamin Pfützer | Sophie Maria Franziska Arrighi
Johann Carl Friedrich Schietzold | Maria Magdalene Jaich
----------------
Oskar Carl Emil Weiss | Auguste Caroline Petzold
Nicol Robel | Barbara Jakob
Friedrich Wilhelm Scheinpflug | Juliane Auguste Däubel
----------------
Karl August Potzsch | Maria Soppa
Karl Gotthelf Endler | Maria Lehmann
Johann Friedrich Gottlob Koch | Emma Klara Staudinger
----------------
Wenzel Nopak | Josepha Nutz
Christian Gotthelf Busch | Anna Birk
Johann Heinrich Bellermann | Berthe Franciska Klieme
----------------
Alexander Joseph Klobukowski | Stanislawa Chrapovicka
Carl Alexander Hoffmann | Mathilde Dunin
----------------
Karl Gottlob Ritter | Maria Anna Anton
Friedrich August Zaumsegel | Maria Auguste Theresia Wilhelm
Johann Benjamin Daniel Krause | Barbara Wilhelmine Auguste Gogl
----------------
Gottfried Feichtinger | Wilhelmine Lagnus
Karl Wilhelm Hegewald | Johanne Christiane Wilhelmine Kayser
----------------
Andreas Urban | Johanne Eleonore Pauline Harmuth
Wilhelm August Preusser | Josephine Mauras
----------------
1852
Carl Heinrich Uhlig | Franciska Lucksch
Johann Traugott Ferdinand Ulbricht | Pauline Christine Mauermann
----------------
Michael Hadam | Anna Pötsch
Gotthelf Adolph Dötlich | Johanna Paul
----------------
Sebastian Vowinkel | Emilie Friederike Weber
Friedrich August Swaton | Auguste Wilhelmine Schäfer
Johann Carl August Guschke | Amalie Theresia Bege
----------------
Carl Friedrich August Hantzsch | Amalie Redlich
Heinrich Ferdinand Auerbach | Agnes Johanna Theresia Schlechter
----------------
Michael Smy | Maria Löschau
Friedrich Gottlob Jahn | Maria Theresia Simang
----------------
Carl August Wahra | Ida Therese Adetheid Nendel
Johann Carl Gottlieb Lehmann | Maria Josepha Reinert
----------------
Julius Waldemar Leibig | Marie Bose
Christian Friedrich Freytag | Caroline Rosalie Bolling
----------------
Ernst Valen | Johanne Therese Krumbholz
Joseph Mahefka | Auguste Amalie Fickel
----------------
Friedrich Poland | Auguste Krütte
Ernst Pollux | Clothilde Sternstein
----------------
Theodosius Joseph Felix Mycielski | Domania Josepha Rutkowska
Michael Polk | Anna Jarsch
----------------
Johann Julius Lobner | Friederike Julie Böhm
Jacob Schoesser | Magdalene Füssel
----------------
Karl Theodor Götz | Johanne Louise Marie Konow
Constanz Florentin Lange | Pauline Bertha Rädler
----------------
Karl August Emil Perrentz | Franciska Genoveva Jäckel
Anton Salomon Thürhüter | Anastasia Beate KrauseKrause
----------------
Karl Anton Ferdinand Hermann | Josepha Maria Angiolini
Johann Georg Eimann | Johanna Theresia Elisabeth Mohr
----------------
Rudolph Ballabene | Maria Therese Janko
Ernst Julius Meyer | Vincentia Wavra
----------------
1853
Friedrich August Köhler | Amalie Auguste Haspel
Johann Gottfried Mieth | Franciska Bronnecker
----------------
Michael Nowak | Maria Wotschk
Johann Friedrich Kahl | Marie Auguste Caspar
----------------
Carl Amandus Kluge | Franciska Elisabeth Theresie Krätschmer
Jacob Petzsch | Christiane Caroline Mildner
----------------
Friedrich Wilhelm Ufer | Christiane Amalie Wilhelmine Bauer
Christian Gottlieb Riemme | Maria Bensch
----------------
Friedrich August Auster | Anna Nartschick
Andreas Kubitz | Emilie Heintze
----------------
Gustav Adolph Büttner | Auguste Therese Jähnel
Johann Joseph Low | Amalie Adolphine Rachel
----------------
Ludwig Bernhard Franz Christophani | Friederike Therese Gotsch
Friedrich Kracht | Josephine Jgnatie Elisabeth Sell
----------------
Johann Friedrich Traugott Naumburger | Maria Anna Georgi
Johann Gottlieb Kohl | Johann Caroline Illiger
----------------
Michael Biebrach | Marie Juliane Ludovika Heieck
Jacob Michael Nuck | Auguste Ernestine Hübner
----------------
Karl August Hille | Antonie Amalie Buzzi
Johann August Kolbe | Emilie Antonie Caroline Redlich
----------------
Johann Friedrich Schüller | Catharina Auguste Wels
Carl Kuebler | Caroline Ernestine Schmuck
----------------
Johann Ehregott Robert Nitsche | Anna Maria Kremser
Karl Gotthelf Ehrenreich Saitenmacher | Agnes Amalie Raabe
----------------
----------------
Georg Schube | Josepha Kintscher
Lambert Joseph Eduard Renkin | Anna Maria Philippine Lejeune
----------------
Johann Gottfried Hentzschel | Elisabeth Slansky
Martin Lehnisch | Agnes Wilhelmine Barthel
----------------
Georg Schäfer | Maria Finck
Johann Gotthelf Wilhelm Rockstroh | Marianna Lalews
----------------
Anton Theodor Gustav Friederici | Anna Maria Felica Lejeune
Johann Joseph Alexander Lebeau | Angela Theresia Maria Trzebinska
----------------
Ernst Wilhelm Staberoh | Anna Rosina Hillen
Heinrich Gottlob Eucharius | Marie Theresie Antonia Franciska Kühne
----------------
Karl Ehregott Fleischhammer | Johann Caroline Riedel
Franz Joseph Müller | Johanna Christiane Ernestie Richter
----------------
Matthes Pellegrini | Christiane Wilhelmine Kersten
Johann Gottfried Wilhelm Kahle | Theresia Amalia Hubert
----------------
1854
Vinzenz Schibitzky | Agnes Harna
Louis Baffarra | Anna Auguste Charlotte Braune
----------------
Karl Rudolph Meyer | Cäcilie Hermine Schlesinger
Karl Wilhelm Dominick | Klara Theresia Buhr
----------------
Ignaz Mathias Clemens Forcht | Maria Augusta Riebestahl
Johann Erdmann Richter | Louise Wolf
Michael Smy | Agnes Schmidt
----------------
Karl Friedrich Wilhelm Serre | Marianna Clementine Cerrini
Georg Rostock | Franziska Havlik
----------------
Johann Traugott Mottke | Katharine Lorenz
Franz Poland | Christiane Katharine Josephine Kobalz
Gustav Leopold Doring | Cäcilie Karoline Rosine Agnes Ullmann
----------------
Johann Ernst Eduard Effenberger | Magdalene Braeuer
Karl August Krönert | Christiane Friderike Schönerin
Friedrich Wilhelm Fischer | Auguste Juliana Hetze
----------------
Johann Friedrich Wilhelm Herrmann | Emilie Ludovvika Milekowska
Karl August Hunger | Elisabeth Wenzl
----------------
Eduard Brendel | Friederike Amalie Auguste Heintz
Gottlob Eduard Riedel | Johanna Grundmann
Heinrich Franz Kercy | Henriette Antonette Johanna Magdalene Just
----------------
Robert Adolph Clemens | Maria Magdalene Rittel
Ernst Friedrich Liebscher | Johanna Puschner
Johann Christian August Dutschmann | Johanne Christiane Weigel
----------------
Hermann Lutteroth | Emma Petrettini
Ludwig Ferdinand Schröder | Anna Elisabeth Cron
----------------
Oscar Rozwadowski | Johanne Serafine Schmidt
Johann Schulze | Marie Magdalena Wotschk
----------------
Anastasius Anton Joseph Ritter | Angelica Schaff
Gustav Hermann Franz | Amalie Auguste Burger
----------------
Adam Joseph Löbmann | Marie Juliane Müller
Louis Hartmann | Ernestine Emilie Panitz
Julius Hermann Schmidt | Franziska Elisabeth Sturm
----------------
Franz Ehrich Anton Etzel | Adolphine Rosalie Gustave Düssler
Casimir Chrzanowski | Bronisla Lipinska
----------------
Karl Ehregott Laßack | Theresia Karoline Pohl
Friedrich Ferdinand Krönert | Franziska Kroh
----------------
1855
Alfred Hompesch | Christina Olga Alexandronne Mengden
Christian Friedrich Asbach | Marie Magdalene Krahl
----------------
Heinrich Emil Abbert | Johanna Eleonora Ney
Johann Christoph Zimmermann | Amalia Auguste Maria Pree
Friedrich August Kögler | Anna Franziska Rosalia Augusta Krumbholz
----------------
Friedrich August Schosmann | Maria Johanna Katharina Therese Fairon
Karl Gottlob Klöpel | Anna Barbara Büttner
Fürchtegott Hugo Wadewitz | Julie Maria Engel
----------------
Friedrich August Pauly | Marianna Laskowska
Ernst Karl Heinrich Wezel | Ana Franziska Ludovica Barbara Hennequin
----------------
Traugott Adolph Voigt | Maria Amalie Leuter
Emil Koch | Theresie Wilhelman Eberl
Gustav Adolph Frauenstein | Wilhelmine Florientine Strassmann
----------------
Christian Wilhelm Hermann Schaller | Agnes Meisl
Wilhelm Ferdinand Philipp | Dominika Klara Könsch
Peter Paul Gassen | Klara Albina König
----------------
Friedrich Wilhelm Thiele | Johanne Josepha Pöhl
Moritz Ignaz Anton Karl Ludwig Franz August Fürstenau | Johanna Friederike Wilhelmine Poser
Georg Hermann Sperling | Auguste Johanne Hedwig Weis
----------------
Franz Gaudernack | Maria Dorothea Sophie Engel
Rudolph Albert Hesse | Marie Theresie Weber
Karl Bernhard Görlach | Johanna Juliane Mathilde Spehr
----------------
Friedrich Wilhelm Liebert | Marie Kunigunde Henriette Karolina Stelzig
August Bamsch | Agnes Robel
Michael Scholze | Maria Waurentschke
----------------
Christian Heinrich Schuster | Magdalene Kzidowk
Johann Friedrich Bokel | Maria Franziska Klepsch
Maria Ludwig Anton Kriebel | Louise Hinsching
----------------
Karl August Köhler | Maria Therese Sommerschuch
Louis Friedrich Wilhelm Schröther | Julia Emilie Schimmerohn
Karl Friedrich Richter | Pauline Hamans
----------------
Johann Aloys Joseph Florian Poland | Henriette Thekla Kriecklitz
Johann Philip Kunert | Adelheid Pauline Beier
Mathias Andreas Gorski | Sophia Podestina Dombski
----------------
Johann Friedrich David Grelmann | Johanne Ernestine Rosalie Wallauchi
Franz Xaver | Marie Mahilde Duering
Michael Mros | Emera Rosalie Fischer
----------------
Ernst Moritz Richter | Antonie Köhl
Theodor Joseph Jacob Maximilian Weis | Auguste Antonie Berge
Karl Gotthelf Großmann | Anna Fischbach
----------------
Karl Otto Gräser | Karoline Friderike Theila Hensel
Julius Joseph Benger | Johanne Sophie Richter
Karl Joseph Friedrich Eduard Rudolph Nove | Wilhelmine Josephine Tichatscheck
----------------
Joseph Anton Peter | Emilie Katherine Kühn
Ernst Leberecht Vogel | Maria Karolina Maleck
Karl Schnor | Antonie Wilhelmine Friederike Hübner
----------------
Johann Christoph Knatz | Agnes Johanna Alexandra Opitz
Johann Heinrich Ludwig Krickow | Friederike Auguste Krumbholz
----------------
1856
Nicol Rudel | Eleonora Hurbank
Ernst Bernhard Schab | Mathilde Faulhaber
Johann Baptist Planer | Christiane Juliana Streubel
----------------
Karl Friedrich August Schelhasse | Anna Hermine Terner
Ernst Friedrich Casper | Apollonia Barbara Franziska Schmeisser
Sebastian Doath | Anna Motz
----------------
Johann Traugott Löbmann | Virginie Magnin
Heinrich Julius Oettrich | Eleonora Theresia Kirchel
Johann Wanack | Anna Schweding
----------------
Karl Gotthelf Hahnwald | Josepha Bek
Christian Ehregott Graefe | Anna Pauline Kadlezeck
Karl August Kühne | Charlotte Henriette Lehnedi
----------------
Johann Joseph Hermann | Anna Leuchert
Friedrich Adolph Thomas | Anna Smeckau
Friedrich Karl Kern | Amalia Theresia Blumentritt
----------------
Eduard Dietrich | Henriette Mathilde Vogel
Karl Eduard Meier | Karoline Paschke
Johann Karl Gottlieb Scheunert | Caroline Wilhelmine Ziegel
----------------
Johann Friedrich Glaser | Maria Theresie Dressler
Karl Lehmann | Laura Antonia Koch
Ernst Eduard Kühnelt | Maria Juliana Johanna Janke
----------------
Johann Adolph Gustav Fischer | Auguste Heyne
Karl Friedrich Franz Gabler | Rosalie Agnes Caroline Günther
Karl Ernst Müller | Rahel Sophie Therese Redlich
----------------
Ferdinand Robert Maier | Johanne Christiane Dorothea Wolf
Friedrich Karl Eduard Rockstroh | Agnes Michel
Johann Christoph Heicke | Malwine Therese Mötig
----------------
Carl Ludwig Oestereich | Margaretha Sachsen
Andreas Nehdo | Anna Böhne
Ferdinand Toscana? | Anna Sachsen
----------------
Eduard Ludwig Rochus Koczerowski | Henriette Agnes Theresie Jaraczewska
----------------
1857
Johann Gottlieb Engwicht | Franziska Anna Maria Kieswetter
Gotthelf Julius Otto Kunzendorf | Margaretha Kugler
Friedrich Louis Kegler | Franziska Klara Ottilie Richter
----------------
Felician Stephan Anton Karp | Anna Gillet
August Robert Lichtenberger | Ursula Brauer
----------------
Johann Theodor Bergerskötter | Amalie Auguste Leiteritz
Karl Theodor Bohrer | Karoline Laura Elisabeth Freund
Maria Friedrich August Johann Nepomuk Forwerk | Maria Anna Josepha Holfeld
----------------
Karl Friedrich Georg Bernstein | Magdalena Quaiser
Michael Schulze | Maria Kubanka
Karl Schöniger | Franziska Walter
----------------
Georg Kilian | Theresia Harbauer
Heinrich August Meißner | Marie Virginie Eulalie Tridon
1853
Friedrich August Albert | Carola Wasa