Lausa (Buch 219)
Trauungen 1644-1657
https://www.archion.de/de/viewer/churchRegister/279983?pageId=38507470

Das ist ein einfacher Index aller Trauungen (nur die Bräutigame)
Die Schreibweise der Namen entspricht nicht immer der Schreibweise im Buch.
Zusätzlich sind einige Namen im Buch nicht klar lesbar.


Erstellt in ca. 0,5 Stunden
September 2023
https://github.com/tintenfrass/simplechurchbookindexes



---------------- x80
1644
Hans Grünberg | Barbara Kutzschlich
Hans Meißner | Katharina Grafen
Christoph Tzschiederich | Maria Hillbrandt
----------------
Christoph Mentzel | Barbara Pretzschen
Merten Thieme | Maria Mentzels
Martin Fleischer | Maria Schütz
Merten Schmid | Martha Johnen
1645
Matthes Careß | Maria Thammen
Christoph Leydold | Maria Creutzen
Hans Schütze | Anna Dronicken
Martin Schütze | Martha ?
----------------
1646
Martin Dronicke | Margareta Kottens
Hans Thamme | Martha Clarin
Martin Kästner | Sophia Köhler
Georgius Görner | Anna Maria Mätzner
----------------
Johann Schütze | Martha Claren
1647
Johann Schütze | Katharina Gebler
Christoph Dreßler | Barbara Grütze
Merten Meißner | Barbara Fleischer
Merten Beutler | Barbara Johnen
----------------
Martin Johne | Anna Thammen
1648
Christoph Meißner | Martha ?
Georg Kutzschlich | Maria Schröder
Caspar Mildner | Anna Maria Thamme
Hans Pfützner | Anna Rudolphs
Caspar Günther | Barbara Fleischer
Christoph Thüring | Maria Leschen
Martin Thamme | Anna Clare
----------------
Georg Dile | Anna Tzschiederich
Martin Leßig | Martha Riemer
Christian Kästner | Martha Schütz
1649
Hans Hörnig | Anna Pietzsche
Merten Beutler | Maria Grütze
Merten Wagner | Katharina Eger
Georg Göckeritz | Martha Grafe
----------------
Hans Schile  Maria | Wagner
Martin Göckeritz | Gertraude Keulings
Andreas Hirdt | Maria Hauffen
Georg Hummel | Margaretha Philips
1650
Michael Meißner | Anna Keßler
Andreas Görner | Sara Schönfeldt
----------------
Michael Kühne | Maria Meege
1651
Elias Untenzu | Dorothea Burghardt
Georg Schütze | Martha Riemer
Gregor Lesche | Anna Fleischer
1652
Tobias Richter | Maria Mentzel
Christoph Schütze | Maria Schütze
----------------
Christoph Habedanck | Margaretha Schütze
Peter Dreßler | Anna Mentzel
Hans Thalheim | Gertraude Schütze
Christoph Großmann | Anna Hirschen
1653
Martin Petzoldt | Anna Schütze
Andreas Wagner | Anna Petri Schütze
----------------
Martin Richter | Martha Pfützner
1654
Georg Leßig | Martha Grützen
Georg Riemer | Maria Burckhardt
Christoph Dreßler | Martha Schmid
Wenzel Rochner | Anna Zaschlin
Paul Meschke | Maria Magdalena Pelech
----------------
Christoph Leßig | Anna Leydold
1655
Georg Hantzsche | Magdalena Rudolph
Johann Lohe | Martha Heyden
Peter Ringel | Maria Biener
Michael Bergman | Maria Grünberg
Hans Mentzel | Anna Mentzel
----------------
Georg Kirscht | Anna Riemer
1656
Michael Schindler | Maria Türcke
Martin Klotzsche | Christina Großmann
Georg Burckhard | Gertraude Keuling
Christoph Arldt | Anna Mentzel
----------------
Georg Schütze | Ortha Gebauer
Friedrich Schuster | Martha Schütz
Georg Hummel | Anna Kotte